State by State Data | The Institute For College Access and Success 

State by State Data | The Institute For College Access and Success






















 




















 






















Search form




Search 
















Working to make higher education more available and affordable for people of all backgrounds




 






















































































































































































































































































































































































State by State Data






 
























 














Project on Student Debt






















State by State Data














Seven in 10 seniors (69%) who graduated from public and nonprofit colleges in 2013 had student loan debt, with an average of $28,400 per borrower. This represents a two percent increase from the average debt of 2012 public and nonprofit graduates.


State- and college-level data on student debt from federal and private loans can be found in the full report. For more details, click on the map and other links on this page.


 















































































































































            Click on a state for in-depth information, or select a state here:          






- Any -
AK - Alaska
AL - Alabama
AR - Arkansas
AZ - Arizona
CA - California
CO - Colorado
CT - Connecticut
DC - District Of Columbia
DE - Delaware
FL - Florida
GA - Georgia
HI - Hawaii
IA - Iowa
ID - Idaho
IL - Illinois
IN - Indiana
KS - Kansas
KY - Kentucky
LA - Louisiana
MA - Massachusetts
MD - Maryland
ME - Maine
MI - Michigan
MN - Minnesota
MO - Missouri
MS - Mississippi
MT - Montana
NC - North Carolina
ND - North Dakota
NE - Nebraska
NH - New Hampshire
NJ - New Jersey
NM - New Mexico
NV - Nevada
NY - New York
OK - Oklahoma
OR - Oregon
PA - Pennsylvania
RI - Rhode Island
SD - South Dakota
SC - South Carolina
TN - Tennessee
TX - Texas
UT - Utah
VA - Virginia
VT - Vermont
WA - Washington
WI - Wisconsin
WV - West Virginia
WY - Wyoming










 






 






 
 
 




 
 
 




 
 
 




 
 
 




 
 
 




 
 
 




 
 
 




 
 
 




 
 
 




 
 
 




 
 
 




 
 
 




 
 
 




 
 
 




 
 
 




 
 
 




 
 
 




 
 
 




 
 
 




 
 
 




 
 
 




 
 
 




 
 
 




 
 
 




 
 
 




 
 
 




 
 
 




 
 
 




 
 
 




 
 
 




 
 
 




 
 
 




 
 
 




 
 
 




 
 
 




 
 
 




 
 
 




 
 
 




 
 
 




 
 
 




 
 
 




 
 
 




 
 
 




 
 
 




 
 
 




 
 
 




 
 
 




 
 
 




 
 
 




 
 
 




 
 
 




















View or download a sortable table of state debt data (by sector) with the option to add individual colleges, other variables, or additional years at:
				
















 and 
 are initiatives of 
, which has licensed these debt data through an agreement with Peterson's. The data are copyright ©2014 Peterson's, a Nelnet company. All rights reserved.






 




 


















Full report


Download the 
:




































 












 

















